type octile
height 15
width 15
map
TTTT...T...T...
TTTT.T.T.T.T.T.
TTTT.T.T.T.T.T.
TTTT.T.T.T.T.T.
TTTT.T.T.T.T.T.
TTTT.T.T.T.T.T.
TTTT.T.T.T.T.T.
T....T...T...T.
T.TTTTTTTTTTTT.
T.TTTTTTTTTTTT.
T..............
TTTTTTTTTTTTTTT
TTTTTTTTTTTTTTT
TTTTTTTTTTTTTTT
TTTTTTTTTTTTTTT
TTTTTTTTTTTTTTT