type octile
height 61
width 61
map
TTTTTTTTTTTTTTTTTTTTTTTTTTTTTTTTTTTTTTTTTTTTTTTTTTTTTTTTTTTTT
T.........T...T...T...T.....T.....................T.T.......T
TTT.T.T.TTT.T.TTT.TTT.TT..TTTTTTTTT.T.T.T.TTT.T.TTT.TTTTT.T.T
T.........T.T...............T...T...T.T.T...T.T.T.T...T.....T
T.T.TT...TT.TTTTT.T.TTT.TTTTTTT.T..TT.T.T.TTTTTT..TTT.T.T.T.T
T...T.T.......T...T.T.T.T.....T...T...T.T...T...........T...T
T...T.T.TTT.TTT.TT..T.TT..TT.TT.T...T.TTTTT.T.T.T..TTTT.TT.TT
T.T.......T...T.T.....T.....T.T.........T...........T.....T.T
T..TTT..T.TTT.T.T.TTT.T.TTTTT.TTT.TTTTTTTTT.TTT.TTT.T.TTT.T.T
T.T.T.T.T.....T...T.T.....T.T.....T.T.....T.T.T.T...T.......T
T.T.T.T.TTT.TTTTTTT.TTT.TTT.TTT.T.T.T.TTT.T.T.TTT.T.T.TTTTT.T
T...T.....T...T...T.T.T.....T.....T.....T.T.T.......T.....T.T
TTT.T.TTTTTTT.TTT.T.T.T.TTTTTT..T.T.TTT...T.T.TTTTTTT.TTT.TTT
T.T.....T.........T...T.....T.T.T...T...T...T.....T...T.....T
T.TTT.TT..TTTTTTTTT.TTTTT...T.T.T.T.T.TTTTTTTTTTT.T.TTT.T.T.T
T...T...T.T...T.T...T...........T.T...........T...T.T...T.T.T
TTT.TTT.T.T.TT....T.TTT.TTT.T.T.TT..TTTTT.T.T.TTTTT.TT.TTTT.T
T.....T...T.........T.T.T...T.T.T...T...T.T.........T.....T.T
T.T.TTT.TTT.T.TTT.TTT.T.T.TTTTTTTTT...T.TTTTT.TTT.TTTTTTT.TTT
T.....T.T...T.T.T.T...T...............T.....T.T.......T...T.T
TTT.TTT...TTTTT.TTTTT...T.TTT..T.TTTT.TTT.T.T...TTT.T.T.T.T.T
T.......T.T.....T...T.......T.....T...T...T.....T.T.T...T.T.T
T.T.TTTTT...T.T.T.TTTT.TTTT.TTT.TTTTT.TTTTTTTTTTT.T.TTT.TTT.T
T.T.....T...T.T.....T.T.T.............T.T...T.T.......T.....T
TTT.T.TTT..T.TTTTTT.T.T.TTT...TT.TT.T.T.T.TTT.T.TTT.TTT.T.T.T
T.....T.T.T...T.....T.T.T...T.T.T...T.....T.....T.....T.T.T.T
T.TTT.T.TTT.TTT.T.T.T.T.TTT.T.T.TTTTT.TTTTTTTTT.TTT.TTT.T.T.T
T...T.........T.T.........T.T...T.........T...T...T.....T...T
TT..T.TTT.TTT.T.T.T.T.T.TTT.T.TTTTTTT.T.T.T.T.T.TTTTT.T.T.TTT
T.T...........T...T...T.....T...T.....T.T...T.......T.T.T...T
T.TTTTTTT.TTT.TTT.TT..TTTTT...TTTTT.TTTTT.TTTTTTT.TTTTT...TTT
T...T.T.T...........T.T.....T.......T.T.T...T.....T.T...T.T.T
T.T.T.T.T.T.TTTTTTT.T.T.TTT.T.T.TTT...T.T.TTTTT.TT..TTT.TTT.T
T.....T.....T...T.T.T.T...T...T...T.....T...........T.....T.T
TTT.TTT.TT.TT.TTT.T.TTTTT.T.T.TTT..TTTT.T.T.TTTTTTT.TTT.T.T.T
T.T...T.....T...T.........T.T...T...T.T.T...T.......T...T.T.T
T.T.T.TTTTT.T.TTT.TTT.TTT.T.TTT..TTTT.T...TTT.TTT.T.TTT.TTT.T
T...T...T.......T.T...............T.T...T.....T...T.T.T.....T
TTT.T.T.T.T.TTTTT.TTT.T.T.TTTTTT..T..TT.TT.T..TTTTTTT.TTT.TTT
T...T.T.T.........T.T.T.T.....T.......T.T.....T.T...........T
T.T..TTTTTT.TTT.TTT.T.TTTTTT..T.T..TT.T.TT.TT.T.T.T.T.TTTTT.T
T...T.........T.T...........T.T...T.........T.T.T...T.T...T.T
T.T.TT.TT.TTT.TTT.T.TTTTT.TTTTT.T.T.TTTTT.T.T.T.TTTTT.TTT.T.T
T.T.............T.T...T.....T.T.....T.T...T.........T.....T.T
TTTT..TT..T.TTTTTTTTT.TTTTT.T.T.TTTTT.TTTTTTT..TT.T..TTTT.T.T
T.T...T...T.T.....T.T...T...............T...T.T.T.T.T.....T.T
T.T.TTTTT.TTT.T.TTT.TT..TTTTTTT..TTTTTT.TTT.T.T.TTT.T.T.T.TTT
T.......T.....T.............T.........T.....T.T...T...T.....T
TTTTT.TTTTTTT.T.TTT.TT.TT.TTT..TTTTT..T.TTTTTTT.T.TTT.TT.TT.T
T.T.....T.....T.T.T.....T.......T.T.T...T.......T.T.....T.T.T
T.T.TTT.TTT.T.T...TTTTT.TTTTTT..T.T.T.T..TTTT.T.T.TTT.T...T.T
T.T.T...T...T...........T.T.........T.T.T.T...T.T...T.....T.T
T.TTT.TTTTTTTTTTTTT.T.T.T.TTTTT.T.TTT.TTT.T.TT.TTTT.T.TTT.TTT
T...T...T.T...T...T.T.....T.......T...T.T.....T.T.T.T.T...T.T
T..TT.TTT.T..TTTT.T.T.T.TTT.TTTTT.TTT.T.TTT.T.T.T.TTTTTTT.T.T
T.T.T.......T.......T.T.........T...T.T...T.......T.T.......T
T.T.TTT.TTT.TT.TT.TTTTTTTTTTTTT.TTTT..T.T.T.TTTTTTT.TTT.T.TTT
T.....T...T...........T.......T.....T...T.....T.T.......T...T
T.T.TT..TTT.T.TTTTT.TTT.TTT.TTTTTTT.T.TTTTT..TT.TTT.TTT.TT..T
T.......T...T.T.........T.........T.....T.........T.........T
TTTTTTTTTTTTTTTTTTTTTTTTTTTTTTTTTTTTTTTTTTTTTTTTTTTTTTTTTTTTT
